GW   WWB B  WW  |
  BW  W B B   B |
WW WBW B B W W  |
     B  BWWWBWWB|
BWWWW WWWB B    |
  W B   W B BW  |
W W  WWWBB B W W|
W  W   B  WWW B |
W  W W W     W  |
WWBW W   WWWBW W|
     BWWW    W  |
W WWB   W W  WW |
B B W WWW  WW   |
 B B  B  W  B   |
WWW  WW  BWWWWWW|
 W   B WW       |
 W W B   WWWWW  |
 WBWWWW    B  WB|
 W  B  WWW WW   |
BWW W WW   W   W|   
    W  W  W  WW |
WWB WBW WBW  W B|
 W    B W W WW  |
 W WW W W   W BW|
BW B  WB WWBW   |
    WW     B W  |
 WW  BWWWWWW WW |
  B B    B    WB|
 W WW WWW WWWW  |
BW  B  BW B W  W|
 WW WWB W  BWB  |
    B     B     |  
WWWWWWWWWWW   WW|
 B   B   WBB BBW|
WB  W W  W BBB W|
W B W WBBWB B BW|
WB BW W  W B B W|
W B W W  W     W|
WB BW B WW     W|
W B WWW        W|
W     W WWWWWWWW|
WWWWW WWWW   B  |
   HW       W   |
 WWWWWWWW WWWW  |
     WWWW   B BW|
BW W B  WB   B B|
  B W  B B WB BW|
   WW  B  WW B B|